1111111111111
1P00000100001
1011101011101
1000001000001
1011101111101
1000100000101
1010111010101
1C000C00101E1
1111111111111
