111111
1P0001
101111
1C0001
1111E1
