1111111111111
1P000001000E1
1011101011101
1000001000001
1011101111101
100010CC00101
1010111010101
1C000C0010001
1111111111111
