111111
1P0001
1C1C01
1000E1
111111
